#######
#     ##
#   #  #
#      #
#     #
 #######
