#######
#     ##
 #  #  #
#      #
#    # #
 #######
