#######
#     ##
 #  #   #
#      #
#    # #
 #######
